1111111111
1000000001
1P10000001
111C100001
1C11100111
1000000001
1001111111
10000000E1
1011111111
10000000C1
1111111111
