11111111111111111111
10100000000001000011
11100000010001C00001
1000C0E0000000C01001
10000000000C00000C01
100C0CC101001C000001
1C0C00100C10101C0101
100100101000011C11C1
10000010000000000001
11000100101001000101
100011001110110000C1
10000CCCC0000001P001
100001000001110100C1
10010000000000000001
1110000000CC00C00001
10000000000000000001
11111111111111111111