1111111
10C0CP1
1010001
1100001
1CC0001
1000001
1C10001
1E00001
1000011
10CCC01
1000011
1CC00C1
1000001
1000011
1000101
1000001
1001C01
1000111
1011001
1000001
1111111