1111111111111111111111111111
11011001000110010000000E0101
1101010110101001000000010101
1P0000C0C00000000000000000C1
1111111111111111111111111111